111111111
10E0000X1
101110001
10C0000P1
101010101
1000C0001
111111111
