11111111111111111111111111111111
1P000000000000C00000000000000001
10000000000000000000000000000001
10000C00000000000000000C00000001
10000000000000000000000000000001
10000000000111111111000000000001
10000000000100000001000000000001
10000C00000100000001000C00000001
10000000000100000001000000000001
10000000000111111111000000000001
10000000000000000000000000000001
10000C00000000000000000C00000001
10000000000000E00000000000000001
11111111111111111111111111111111