11111111111111
1000P0000E0001
1X000000000001
10CCCC00C00001
10000000000001
10000C10000001
11111111111111