1111111111111111111111111
11011111111110000000000E1
1000000000000000000000001
1011101111111111111111111
1000000000000000000000001
1011111111111111111111111
1000000000000000000000P01
1011111110000011111111001
10000C00000000000000C00X1
1000000000000000000000001
1111111111111111111111111