1111111111111111111111111
1X00000000000000000000001
1C00000000C00000000000C01
1000000000000000000000001
10000C0000000P00000C00001
1000000000000000000000001
1000000000C00000000000001
1C000000000000000000000C1
1000000000000000000000001
1000000000000000000000001
1011111111110000011111111
10000C0000000000000C00001
1C00000000000000000000C01
10000000000E0000000000001
1111111111111111111111111
