111111111
11E1000X1
100010001
10C0000P1
101010101
1000C0001
111111111
