111111111
100000001
101110001
1000E0P01
101010101
100000001
111111111
