111111111
1000000X1
101110001
10C0E0PC1
101010101
1000C0X01
111111111
