11111111111
1000P0000E1
1X000000001
10000C00001
11111111111