111111111111111111111111111111
1011101111111111100000000000E1
100000000000000000000000000001
101110111111111111111111111111
100000000000000000000000000001
101111111111111111111111111111
100000000000000000000000000P01
101110111111111111111111111111
100000100000100000000000000001
101110100000111111111111111111
100000C00000000000000000000001
101110111100000111111111111001
10000C0000000000000000000C00X1
100000000000000000000000000001
111111111111111111111111111111