1111111
1P1C0E1
1110101
10000X1
1111111
