11111111
1000P001
1X11C001
10001101
1011C001
1000E001
11111111

