1111111
1P0C0E1
1010101
10000X1
1111111
