1111111
1E0C0X1
1110111
100P001
1111111