111111111111111111111111111111
1P0000000000000000000000000001
101111111111111111111111111101
101000000000000000000000000001
101011111111111111111111111101
101010000000000000000000000001
101010111111111111111111111101
1010101000000000000000000000X1
101010101111111111111111111101
101010101000000000000000000001
101010101011111111111111111101
101010101010000000000000000001
101010101010101111111111111101
10000C0000000000000000000000E1
111111111111111111111111111111
