11111
10P01
1C0X1
10E01
11111
