111111111
1P0000X11
101110001
1C0E01111
111111111
